R = 1904 1080

NO = textures/redbrick.xpm
SO = textures/purplestone.xpm
WE = textures/greystone.xpm
EA = textures/mossy.xpm
S = textures/armor.xpm

F = 0,0,0
C = 63,6,63

1111111111111111111111111111111
100000000000000000110000000001
111110000000000011120000211111
 10000000000000001 100000011111
1000000000000000111000000000001
1111100000000020000002000000011
100000000N000000000000000000001111
1000000000000000000000000000001
100000000020000200000200000001
10000000000000000000000000211
100000000000000000000000000001
111111111111111111111111111111
