R = 1920 1024

NO = textures/redbrick.xpm
SO = textures/purplestone.xpm
WE = textures/greystone.xpm
EA = textures/mossy.xpm

S = textures/barrel.xpm

F = 128,255,128
C = 128,128,128

1111111111111111111111111111111111
    1000000000110000000000001
1111100000000000000020000011
100000000000000000000000111111111
100000000000000000000000000001
100000000000000002000000000001
100000000000000000000000000001
1000000000000000000000000000001
100000000000000000000000000001
1000000000000N0000000000000001
100000000000000000000000000001
100000000000000000000000000001
1000000000000000000000000000001111111111
100000000000000002000000000001
100000000000000000000000000001
100000000000000002000000000001
100000000000000000000000000001
1100000111010111111101111000111
11111111 1111111  11111 11111
