R = 1500 1024

NO = textures/redbrick.xpm
SO = textures/purplestone.xpm
WE = textures/greystone.xpm
EA = textures/mossy.xpm

S = textures/armor.xpm

F = 19,63,6
C = 63,6,63

1111111111111111111111111111111111
    1000000000110000000000001
1111100000000000000020000011
100000000000000000000000111111111
100000000000000000000000000001
100000000020000002000000000001
100000000000000000000000000001
1000000000000000000000000000001
100000000020000200000200000001
1000000000000E0000000000000001
100000000000000000000000000001
11111111111111111111111111111
