R = 1920 1024

NO = textures/redbrick.xpm
SO = textures/purplestone.xpm
WE = textures/greystone.xpm
EA = textures/mossy.xpm

S = textures/armor.xpm

F = 128,255,128
C = 128,128,128

111111111111111111111111
100000000000000000000001
100000000000000000000001
100000000000000000000001
100000000000000000000001
10000000000000000000000111111
10000000000000000000000000001
10000000000000000000000111111
100000000000000000000001
111111111111111111111111


