R = 1920 1024

NO = textures/redbrick.xpm
SO = textures/purplestone.xpm
WE = textures/greystone.xpm
EA = textures/mossy.xpm
S = textures/armor.xpm

F = 19,63,6
C = 63,6,63

1111111111111111111111111111111111111
    10000000000000000110000000000001
111110000000000000002000021111111111
100000000000000000000000111111111111
100000000000000000000000000000000001
100000000020000002000000000001111111
10000000000000000000000000000111
1000000000000000000000000000001
100000000020000200000200000001
1000000000000W0000000000000021
100000000000000000000000000001
111111111111111111111111111111
