R = 1920 1080

NO = textures/redbrick.xpm
SO = textures/purplestone.xpm
WE = textures/greystone.xpm
EA = textures/purplestone.xpm

S = textures/armor.xpm

F = 220,100,0
C = 225,30,0

1111111111111111111111111
1000000000110000000000001
1011000001110000002000001
1001000000000000000000001
1111111110110000011100001
1000000000110000011101101
1111011111111101110000001
1111011111111101110101001
1100000011010101110000001
100020000000000011000N001
1000000000000000110101001
1100000111010101111101111
1111111111111111110111111