R 1920 1024

NO  textures/redbrick.xpm
SO  textures/purplestone.xpm
WE  textures/greystone.xpm
EA  textures/mossy.xpm
S   textures/armor.xpm

F  0,0,0
C  0,0,0

11111111111111111111111111111111
10000011111000000001100000000000111
100001    10000000000000000000000001
10000011111000000000000000001111111
10000000000000001110000000000001
1111100000000020000002000000011
100000000000000000000000000001111
1000000000000000000000000000001
100000000020000200000200000001111111
100E0000000000000000000002111
10000000000000000000000000000111111
111111111111111111111111111111
