R = 1920 1024

NO = textures/redbrick.xpm
SO = textures/purplestone.xpm
WE = textures/greystone.xpm
EA = textures/mossy.xpm

S = textures/barrel.xpm

F = 19,63,6
C = 63,6,63

1111111111111111111111111111111111
    1000000000110000000000001
1111100000000000000020000011
100000000000000000000000111111111
100000000000000000000000000001
100000000000000002000000000001
100000000000000000000000000001
1000000000000000000000000000001
100000000000000000000000000001
1000000000000E0000000000000001
100000000000000000000000000001
100000000000000000000000000001
1000000000000000000000000000001
100000000000000002000000000001
100000000000000000000000000001
100000000000000002000000000001
100000000000000000000000000001
1100000111010111111101111000111
11111111 1111111  11111 11111
