R = 1920 1024

NO = textures/redbrick.xpm
SO = textures/purplestone.xpm
WE = textures/greystone.xpm
EA = textures/mossy.xpm

S = textures/barrel.xpm

F = 128,255,128
C = 128,128,128

    11111111111111111111111111111
    1000000000110000000000001
    100000011100000020000011
    10010000000000000000000011111
111111111011000001110000000000001
100000200011000001110111111111111
11110111111111011100000010001
11110111111111011101010010001
11000000110101011100000010001
10000020000000001100020010001
10000000000000001101010010001
1100000111010101111101111000111
11111111 1111111  11111 11111
